40
40
22 22 22 22 22 22 20 20 22 22 22 22 22 22 22 22 22 22 22 2 2 2 2 2 2 2 2 22 22 22 22 22 22 22 22 2 20 2 2 20 
20 22 2 2 22 22 22 22 20 22 22 22 22 22 22 22 22 22 22 2 2 2 2 2 2 2 2 22 22 22 22 22 22 22 22 2 20 2 2 20 
22 20 2 2 2 2 2 2 2 2 2 20 22 22 22 22 22 22 22 2 22 2 2 2 2 2 2 2 2 22 22 22 22 22 22 2 20 21 20 20 
22 2 20 2 22 2 2 2 2 2 2 20 22 22 22 22 22 2 2 2 2 22 2 2 22 2 2 2 22 22 22 22 22 22 22 2 2 2 2 20 
22 2 2 2 20 20 20 20 20 22 22 22 22 22 22 22 22 22 2 2 2 2 22 2 2 2 2 22 22 22 22 22 22 22 22 22 22 22 22 20 
22 2 2 2 20 2 20 2 20 22 22 22 22 22 22 22 22 22 2 2 2 2 2 2 2 2 2 22 22 22 22 22 22 22 22 22 22 22 22 20 
22 2 2 2 2 20 20 20 20 22 22 22 22 22 22 22 22 2 2 2 2 2 2 2 2 2 22 2 22 22 22 22 22 22 22 22 22 22 22 20 
22 22 22 22 22 2 2 22 22 22 22 22 22 22 22 22 22 2 2 2 22 22 2 2 2 2 22 2 2 2 2 22 22 22 22 22 22 22 22 20 
22 22 22 22 22 22 22 22 22 22 22 22 22 22 22 22 22 2 2 2 2 2 2 22 22 22 22 22 22 22 22 22 22 22 22 22 22 22 22 20 
22 22 22 22 22 22 22 22 22 22 22 22 22 22 22 22 22 22 2 2 2 22 22 22 22 22 22 22 2 22 22 22 22 22 22 22 22 22 22 20 
22 22 22 22 22 22 22 22 22 22 22 22 22 22 22 22 22 22 2 2 2 2 22 22 22 22 22 22 2 22 22 22 22 22 22 22 22 22 22 20 
22 22 22 22 22 22 22 22 22 22 22 22 22 22 22 22 22 22 2 2 22 22 22 22 22 22 22 22 2 22 22 22 22 22 22 22 22 22 22 20 
22 22 22 22 22 22 22 22 22 22 22 22 22 22 22 22 22 22 2 2 2 2 2 2 2 2 22 22 22 22 2 22 22 22 22 22 22 22 22 20 
22 22 22 22 22 22 22 22 22 22 22 22 22 22 22 22 22 22 22 22 2 2 2 2 2 2 22 22 22 2 2 2 2 2 22 22 22 22 22 20 
22 22 22 22 22 22 22 22 22 22 22 22 22 22 22 22 22 22 22 22 22 22 2 2 22 22 22 22 22 22 22 22 22 22 22 22 22 22 22 20 
22 22 22 22 22 22 22 22 22 22 22 22 22 2 22 22 22 22 22 22 22 22 22 2 2 22 22 22 22 22 22 22 22 22 22 22 22 22 22 20 
20 2 2 2 2 2 2 2 2 2 22 22 22 22 22 22 2 2 22 22 2 2 2 22 22 22 2 2 22 22 22 22 22 22 22 22 22 22 22 20 
20 22 22 22 22 2 22 22 22 22 22 22 22 2 2 2 2 2 2 22 22 22 22 22 2 22 22 22 22 22 22 22 22 22 22 22 22 22 22 20 
20 1 1 1 1 1 2 2 2 22 22 22 22 22 22 2 2 2 2 2 2 22 22 22 22 2 2 22 22 22 22 22 22 22 22 22 22 22 22 20 
20 1 1 1 1 1 1 2 2 22 22 22 22 22 22 2 2 2 2 22 22 22 22 2 2 2 22 22 22 22 22 22 22 22 22 22 22 22 22 20 
20 1 1 1 1 1 1 2 2 22 22 22 22 22 22 2 2 2 2 2 22 22 22 22 22 22 22 22 22 22 22 22 22 22 22 22 22 22 22 20 
20 20 1 1 1 1 2 2 2 2 22 22 22 22 22 22 22 22 22 22 22 22 2 22 22 22 22 22 22 22 22 22 22 22 22 22 22 22 22 20 
20 20 20 2 20 20 22 22 22 22 22 22 22 22 22 22 22 22 22 22 2 2 2 22 22 22 22 22 22 22 22 22 22 22 22 22 22 22 22 20 
20 22 22 2 22 22 22 22 22 22 22 22 22 22 22 22 22 22 22 22 2 2 22 22 22 22 22 22 22 22 22 22 22 22 22 22 22 22 22 20 
20 22 22 2 22 22 22 22 22 22 22 22 22 22 22 22 22 22 22 22 2 22 22 22 22 22 22 22 22 22 22 22 22 22 22 22 22 22 22 20 
20 22 22 2 22 22 22 22 22 22 22 22 22 22 22 22 22 22 22 22 22 22 22 22 22 22 22 22 22 22 22 22 22 22 22 22 22 22 22 20 
20 22 22 2 22 22 2 22 22 22 22 22 22 22 22 22 22 22 22 22 22 22 22 22 22 22 22 22 22 22 22 22 22 22 22 22 22 22 22 20 
20 22 22 2 22 22 2 22 22 22 22 22 22 22 22 22 22 22 22 22 22 22 22 22 22 22 22 22 22 22 22 22 22 22 22 22 22 22 22 20 
20 22 22 2 22 22 2 22 22 22 22 22 22 22 22 22 22 22 22 22 22 22 22 22 22 22 22 22 22 22 22 22 22 22 22 22 22 22 22 20 
20 2 2 2 2 2 22 22 22 22 22 22 22 22 22 22 22 22 22 22 22 22 22 22 22 22 22 22 22 22 22 22 22 22 22 22 22 22 22 20 
22 20 20 20 22 22 22 22 22 22 22 22 22 22 22 22 22 22 22 22 22 22 22 22 22 22 22 22 22 22 22 22 22 22 22 22 22 22 22 20 
22 22 22 22 22 22 22 22 22 22 22 22 22 22 22 22 22 22 22 22 22 22 22 22 22 22 22 22 22 22 22 22 22 22 22 22 22 22 22 20 
22 22 22 22 22 22 22 22 22 22 22 22 22 22 22 22 22 22 22 22 22 22 22 22 22 22 22 22 22 22 22 22 22 22 22 22 22 22 22 20 
22 22 22 22 22 22 22 22 22 22 22 22 22 22 22 22 22 22 22 22 2 22 22 22 22 22 22 22 22 22 22 22 22 22 22 22 22 22 22 20 
22 22 22 22 22 22 22 22 22 22 22 22 22 22 22 22 22 22 2 2 2 2 22 22 22 22 22 22 22 22 22 22 22 22 22 1 1 1 1 20 
22 22 22 22 22 22 22 22 22 22 22 22 22 22 22 22 2 2 2 2 2 2 2 22 22 22 22 22 22 22 22 22 22 22 22 1 1 1 1 20 
22 22 22 22 22 22 22 22 22 22 22 22 22 22 22 22 2 2 2 2 2 2 2 22 22 22 22 22 22 22 22 22 22 22 22 1 1 1 1 20 
22 22 22 22 22 22 22 22 22 22 22 22 22 22 22 22 2 2 2 2 2 2 2 22 22 22 22 22 22 22 22 22 22 22 22 1 1 1 1 20 
22 22 22 22 22 22 22 22 22 22 22 22 22 22 22 22 22 2 2 2 22 22 22 22 22 22 22 22 22 22 22 22 22 22 22 1 1 1 1 20 
22 22 22 22 22 22 22 22 22 22 22 22 22 22 22 22 22 22 2 2 22 22 22 22 22 22 22 22 22 22 22 22 22 22 22 20 20 20 20 20 
